W W W W W W W W W W W W W W W W W W W
W S S S S S S S S W S S S S S S S S W
W S W W S W W W W W W W W W S W W S W
W S S S S S S S S S S S S S S S S S W
W S W W S W S W W W W W S W S W W S W
W S S S S W S S S W S S S W S S S S W
W W W W S W W W S W S W W W S W W W W
W W W W S W S S S S S S S W S W W W W
W W W W S W S W S W S W S W S W W W W
W S S S S S S W G S G W S S S S S S W
W W W W S W S W W W W W S W S W W W W
W W W W S W S S S S S S S W S W W W W
W W W W S W S W W W W W S W S W W W W
W S S S S S S S S W S S S S S S S S W
W S W W S W W W W W W W W W S W W S W
W S S W S S S S S P S S S S S W S S W
W W S W S W S W W W W W S W S W S W W
W S S S S W S S S W S S S W S S S S W
W S W W W W W W S W S W W W W W W S W
W S S S S S S S S S S S S S S S S S W
W W W W W W W W W W W W W W W W W W W